A.C. Green	F
A.J. English	G
A.J. Guyton	G
A.J. Price	G
A.J. Wynder	G
Aaron Brooks	G
Aaron Gordon	F
Aaron Gray	C
Aaron James	F
Aaron McKie	G
Aaron Swinson	F
Abdul Jeelani	F
Acie Earl	F,C
Acie Law	G
Adam Harrington	G
Adam Keefe	F
Adam Morrison	F
Adolph Hoefer	G
Adonal Foyle	C
Adonis Thomas	G,F
Adreian Payne	F,C
Adrian Branch	F
Adrian Dantley	F
Adrian Griffin	G,F
Adrian Smith	G
Al Bianchi	G
Al Brightman	F
Al Butler	G
Al Carlson	C
Al Cervi	G
Al Eberhard	F
Al Ferrari	G
Al Fleming	F
Al Guokas	F
Al Hairston	G
Al Harrington	F
Al Henry	C
Al Horford	F,C
Al Jackson	G
Al Jefferson	C
Al Lucas	F
Al Lujack	F
Al Masino	G
Al McGuire	G
Al Miksis	C
Al Negratti	F
Al Roges	F
Al Skinner	G
Al Thornton	F
Al Tucker	F
Al Wood	G
Al-Farouq Aminu	F
Alaa Abdelnaby	F
Alan Anderson	G,F
Alan Hardy	G
Alan Henderson	F,C
Alan Ogg	C
Alan Sawyer	F
Albert King	F
Alec Burks	G
Alec Kessler	F
Alex Acker	G
Alex Blackwell	F
Alex Bradley	F
Alex English	F
Alex Groza	C
Alex Hannum	F
Alex Kirk	C
Alex Len	C
Alex Stivrins	F
Alexander Ellis	F
Alexander Johnson	F
Alexander Rosenberg	G
Alexander Volkov	C
Alexey Shved	G
Alexis Ajinca	C
Alfredrick Hughes	F
Allan Bristow	F
Allen Crabbe	G
Allen Iverson	G
Allen Leavell	G
Allen Murphy	G
Allie McGuire	G
Alonzo Bradley	F
Alonzo Gee	F
Alonzo Mourning	C
Alphonso Ford	F
Alton Lister	F,C
Alvan Adams	C
Alvin Attles	G
Alvin Heggs	F
Alvin Holt	F
Alvin Jones	C
Alvin Robertson	G
Alvin Scott	F
Amal McCaskill	C
Amar'e Stoudemire	F,C
Amir Johnson	F
Anderson Varejao	C
Andray Blatche	F,C
Andre Dawkins	G
Andre Drummond	C
Andre Iguodala	G,F
Andre McCarter	G
Andre Miller	G
Andre Moore	F
Andre Owens	G
Andre Roberson	G
Andre Spencer	F
Andre Turner	G
Andre Wakefield	G
Andrea Bargnani	F,C
Andrei Kirilenko	F
Andres Guibert	C
Andrew Bogut	C
Andrew Bynum	C
Andrew Goudelock	G
Andrew Lang	C
Andrew Levane	F
Andrew Nicholson	F
Andrew Toney	G
Andrew Wiggins	F
Andy Duncan	F
Andy Johnson	F
Andy Kostecka	F
Andy O'Donnell	G
Andy Phillip	G
Andy Rautins	G
Andy Tonkovich	G
Andy Toolson	F
Andy Walker	G
Angelo Musi	G
Anthony Avent	C
Anthony Bennett	F
Anthony Bonner	F
Anthony Bowie	G
Anthony Cook	F
Anthony Davis	F,C
Anthony Frederick	F
Anthony Grundy	G
Anthony Johnson	G
Anthony Jones	G
Anthony Mason	F
Anthony Morrow	G
Anthony Parker	G
Anthony Peeler	G
Anthony Pullard	F
Anthony Randolph	F
Anthony Roberson	G
Anthony Roberts	F
Anthony Taylor	G
Anthony Tolliver	F
Anthony Tucker	F
Antoine Walker	F
Antonio Burks	G
Antonio Daniels	G
Antonio Harvey	F,C
Antonio McDyess	F,C
Antonis Fotsis	F
Archie Clark	G
Archie Dees	F
Archie Goodwin	G
Ariel Maughan	F
Arlen Bockhorn	G
Armand Cure	F
Armen Gilliam	F
Armon Johnson	G
Armond Hill	G
Arnett Moultrie	F
Arnie Ferrin	F
Arnie Johnson	F
Arnie Risen	C
Aron Baynes	F,C
Arron Afflalo	G
Art Burris	F
Art Collins	G
Art Harris	G
Art Heyman	G
Art Hillhouse	C
Art Long	F
Art Spector	F
Art Spoelstra	C
Art Stolkey	G
Arthur Williams	G
Artis Gilmore	C
Arvid Kramer	C
Arvydas Macijauskas	G
Arvydas Sabonis	C
Askia Jones	F
Aubrey Davis	G
Audie Norris	C
Audley Brindley	F
Austin Carr	G
Austin Daye	F
Austin Rivers	G
Avery Bradley	G
Avery Johnson	G
Awvee Storey	G,F
B.J. Armstrong	G
B.J. Tyler	G
Bailey Howell	F
Barney Cable	F
Baron Davis	G
Barry Kramer	F
Barry Nelson	C
Barry Orms	G
Barry Stevens	G
Barry Sumpter	F
Barry Yates	F
Bart Kofoed	F
Bato Govedarica	G
Bayard Forrest	C
Bear, The Body Hoffman	G
Belus Smawley	G
Ben Clyde	F
Ben Coleman	F
Ben Gillery	C
Ben Goldfaden	F
Ben Gordon	G
Ben Handlogten	C
Ben Hansbrough	G
Ben Kelso	G
Ben McDonald	F
Ben McLemore	G
Ben Poquette	F
Ben Schadler	F
Ben Scharnus	F
Ben Uzoh	G
Ben Wallace	F,C
Ben Warley	F
Bennie Swain	F
Beno Udrih	G
Bernard James	C
Bernard King	F
Bernard Robinson	G,F
Bernard Thompson	G
Bernard Toone	F
Bernie Fryer	G
Bernie Harris	F
Bernie Williams	G
Bert Cook	G
Bill Bolger	F
Bill Bradley	F
Bill Bridges	F
Bill Buntin	C
Bill Calhoun	F
Bill Cartwright	C
Bill Chamberlain	F
Bill Closs	F
Bill Davis	F
Bill Dinwiddie	F
Bill Downey	C
Bill Ebben	G
Bill Edwards	F
Bill Fenley	F
Bill Garnett	F
Bill Hanzlik	F
Bill Henry	C
Bill Herman	G
Bill Hewitt	F
Bill Jones	F
Bill Kenville	G
Bill Laimbeer	C
Bill Ligon	G
Bill Martin	F
Bill Mayfield	F
Bill McGill	C
Bill Melchionni	G
Bill Miller	F
Bill Mlkvy	F
Bill Robinzine	F
Bill Russell	C
Bill Sharman	G
Bill Smith	C
Bill Smith	F
Bill Stricker	F
Bill Thieben	F
Bill Tosheff	G
Bill Turner	F
Bill Walton	C
Bill Willoughby	F
Bill Zopf	G
Billy Cunningham	F
Billy Donovan	G
Billy Gabor	G
Billy Hassett	G
Billy Knight	F
Billy McKinney	G
Billy Owens	G,F
Billy Paultz	C
Billy Reid	G
Billy Thomas	G
Billy Thompson	F
Billyray Bates	G
Bimbo Coles	G
Bingo Smith	F
Bismack Biyombo	F,C
Bison Dele	F,C
Blaine Denning	G
Blair Rasmussen	F
Blake Ahearn	G
Blake Griffin	F
Bo Ellis	F
Bo Erias	F
Bo Kimble	G
Bo Lamar	G
Bob Allen	F
Bob Anderegg	F
Bob Armstrong	C
Bob Arnzen	F
Bob Bigelow	F
Bob Boozer	F
Bob Brannum	F
Bob Brown	F
Bob Burrow	C
Bob Carney	C
Bob Carpenter	F
Bob Carrington	G
Bob Christian	C
Bob Cousy	G
Bob Dandridge	F
Bob Davies	G
Bob Davis	F
Bob Dille	F
Bob Doll	F
Bob Donham	G
Bob Duffy	F
Bob Duffy	G
Bob Elliott	C
Bob Evans	G
Bob Faught	F
Bob Feerick	G
Bob Ferry	C
Bob Fitzgerald	F
Bob Gantt	F
Bob Greacen	F
Bob Gross	F
Bob Hahn	C
Bob Hansen	G
Bob Harris	F
Bob Harrison	G
Bob Hogsett	F
Bob Hopkins	C
Bob Houbregs	C
Bob Hubbard	C
Bob Kauffman	F
Bob Kinney	C
Bob Knight	G,F
Bob Lanier	C
Bob Lavoy	F
Bob Leonard	G
Bob Lochmueller	F
Bob Love	F
Bob Martin	C
Bob McAdoo	C
Bob McNeill	G
Bob Miller	F
Bob Mullens	G
Bob Naber	F
Bob Nash	F
Bob O'Brien	F
Bob Peterson	F
Bob Pettit	F
Bob Portman	F
Bob Priddy	F
Bob Quick	F
Bob Riley	F
Bob Royer	G
Bob Rule	C
Bob Santini	F
Bob Schafer	G
Bob Shea	F
Bob Sims	F
Bob Sura	G
Bob Thornton	F
Bob Tough	G
Bob Verga	G
Bob Warlick	G
Bob Weiss	G
Bob Wiesenhahn	F
Bob Wilkerson	G
Bob Williams	F
Bob Wilson	G
Bob Wood	G
Bobby Brown	G
Bobby Cattage	F
Bobby Cook	G
Bobby Hurley	G
Bobby Jackson	G
Bobby Jones	F
Bobby Jones	F
Bobby Lewis	G
Bobby Simmons	F
Bobby Smith	G
Bobby Wanzer	G
Bobby Washington	G
Bobby Wilson	G
Bojan Bogdanovic	G,F
Bonzi Wells	G,F
Boris Diaw	F
Boris Nachamkin	F
Bostjan Nachbar	F
Bracey Wright	G
Brad Branson	F
Brad Daugherty	C
Brad Davis	G
Brad Holland	G
Brad Lohaus	F,C
Brad Miller	F,C
Brad Sellers	F
Brad Wright	F
Bradley Beal	G
Brady Walker	F
Brandan Wright	F
Brandon Armstrong	G
Brandon Bass	F
Brandon Davies	F
Brandon Hunter	F
Brandon Jennings	G
Brandon Knight	G
Brandon Roy	G
Brandon Rush	G,F
Brant Weidner	F
Brendan Haywood	C
Brendan McCann	G
Brent Barry	G
Brent Price	G
Brent Scott	F,C
Brett Szabo	C
Brett Vroman	C
Brevin Knight	G
Brian Butch	C
Brian Cardinal	F
Brian Cook	F,C
Brian Davis	F
Brian Grant	F,C
Brian Heaney	G
Brian Howard	F
Brian Martin	F
Brian Quinnett	G
Brian Roberts	G
Brian Rowsom	F
Brian Scalabrine	F
Brian Shaw	G
Brian Taylor	G
Brian Winters	G
Brook Lopez	C
Brook Steppe	G
Bruce Bowen	F
Bruce Douglas	G
Bruce Flowers	F
Bruce Hale	G
Bruce Kuczenski	F
Bruce Seals	F
Bruno Caboclo	F
Bruno Sundov	C
Bryan Warrick	G
Bryant Reeves	C
Bryant Stith	G
Bubba Wells	F
Buck Johnson	F
Buck Williams	F
Bud Grant	F
Bud Koper	G
Buddy Jeannette	G
Butch Beard	G
Butch Carter	G
Butch Feher	G
Butch Graves	F
Butch Lee	G
Butch Van Breda Kolff	G,F
Byron Beck	C
Byron Dinkins	G
Byron Houston	F
Byron Irvin	G
Byron Mullens	C
Byron Scott	G
Cal Bowdler	F
Cal Christensen	F
Cal Ramsey	F
Calbert Cheaney	G,F
Caldwell Jones	C
Calvin Booth	C
Calvin Garrett	F
Calvin Murphy	G
Calvin Natt	F
Cameron Bairstow	F,C
Campy Russell	F
Carey Scurry	F
Carl Bailey	C
Carl Braun	G
Carl Henry	G
Carl Kilpatrick	C
Carl Landry	F
Carl McNulty	G
Carl Meinhold	G
Carl Nicks	G
Carl Shaeffer	G
Carl Thomas	G
Carlos Arroyo	G
Carlos Boozer	F
Carlos Clark	G
Carlos Delfino	G,F
Carlos Ogden	F
Carlos Rogers	F,C
Carlos Terry	G
Carlton McKinney	F
Carmelo Anthony	F
Caron Butler	F
Carrick Felix	G,F
Cartier Martin	F
Casey Jacobsen	G
Casey Shaw	C
Casper Ware	G
Cazzie Russell	F
Cecil Hankins	G
Cedric Ball	F
Cedric Ceballos	F
Cedric Henderson	F
Cedric Henderson	F
Cedric Hunter	F
Cedric Jackson	G
Cedric Lewis	F
Cedric Maxwell	F
Cedric Simmons	F
Cedrick Hordges	C
Cezary Trybanski	C
Chad Gallagher	C
Chad Kinch	G
Chandler Parsons	F
Channing Frye	F
Charles Acton	F
Charles Barkley	F
Charles Bradley	G
Charles Claxton	C
Charles Dudley	G
Charles Hayes	F,C
Charles Jenkins	G
Charles Jones	F,C
Charles Jones	F
Charles Kupec	C
Charles Nash	F
Charles O'Bannon	G
Charles Oakley	F
Charles R. Jones	G
Charles Shackleford	C
Charles Smith	F
Charles Smith	F
Charles Thomas	G
Charles Vaughn	G
Charles Whitney	F
Charlie Bell	G
Charlie Black	F
Charlie Criss	G
Charlie Davis	F
Charlie Davis	G
Charlie Hardnett	F
Charlie Johnson	G
Charlie Parsley	G
Charlie Paulk	F
Charlie Pittman	F
Charlie Scott	G
Charlie Share	C
Charlie Shipp	G
Charlie Sitton	F
Charlie Tyra	C
Charlie Villanueva	F
Charlie Yelverton	G
Chase Budinger	F
Chauncey Billups	G
Chet Aubuchon	G
Chet Carlisle	F
Chet Walker	F
Chris Andersen	F,C
Chris Anstey	C
Chris Babb	G
Chris Bosh	C
Chris Childs	G
Chris Copeland	F
Chris Corchiani	G
Chris Crawford	F
Chris Douglas-Roberts	G
Chris Dudley	C
Chris Duhon	G
Chris Engler	C
Chris Ford	G
Chris Garner	G
Chris Harris	G
Chris Herren	G
Chris Hunter	F,C
Chris Jefferies	F
Chris Johnson	F
Chris Kaman	C
Chris McNealy	F
Chris Mihm	C
Chris Mills	F
Chris Morris	F
Chris Munk	F
Chris Owens	F
Chris Paul	G
Chris Porter	F
Chris Quinn	G
Chris Richard	F
Chris Robinson	G
Chris Singleton	F
Chris Smith	G
Chris Taft	F
Chris Washburn	C
Chris Welp	C
Chris Whitney	G
Chris Wilcox	F,C
Chris Wright	F
Christian Eyenga	F
Christian Laettner	F,C
Chuck Aleksinas	C
Chuck Connors	F
Chuck Cooper	F
Chuck Gilmur	F
Chuck Grigsby	G
Chuck Halbert	C
Chuck Lowery	G
Chuck Mencel	G
Chuck Mrazovich	F
Chuck Nevitt	C
Chuck Noble	G
Chuck Osborne	F
Chuck Person	F
Chuck Terry	G
Chuck Williams	G
Chuckie Williams	G
Chucky Atkins	G
Chucky Brown	F
CJ McCollum	G
CJ Miles	G
CJ Watson	G
CJ Wilcox	G
Clar. Weatherspoon	F
Clarence Glover	F
Clarence Hermsen	C
Clarence Kea	F
Clark Kellogg	F
Claude English	G
Claude Gregory	F
Claude Overton	G
Claude Terry	G
Clay Johnson	G
Cleanthony Early	F
Clem Haskins	G
Clemon Johnson	C
Cleo Hill	G
Cleveland Buckner	F
Cliff Anderson	G
Cliff Barker	G
Cliff Hagan	F
Cliff Levingston	F
Cliff Meely	F
Cliff Pondexter	F
Cliff T. Robinson	F
Cliff Williams	G
Clifford Lett	G
Clifford Ray	C
Clifford Robinson	F,C
Clint Capela	C
Clint McDaniel	G
Clint Richardson	G
Clint Wager	C
Clinton Smith	F
Clinton Wheeler	G
Clyde Drexler	G
Clyde Lee	F
Clyde Lovellette	C
Clyde Mayes	F
Coby Dietrick	C
Coby Karl	G
Cody Zeller	F,C
Cole Aldrich	C
Conner Henry	G
Connie Dierking	C
Connie Hawkins	F
Connie Norman	G
Connie Rea	G
Connie Simmons	C
Corey Beck	G
Corey Brewer	G,F
Corey Crowder	F
Corey Gaines	G
Corey Maggette	F
Corey Williams	G
Corie Blount	F,C
Corky Calhoun	F
Corliss Williamson	F
Cornelius Cash	F
Cornell Warner	F
Corny Thompson	F
Cory Alexander	G
Cory Blackwell	F
Cory Carr	G
Cory Jefferson	F
Cory Joseph	G
Costic Borsavage	C
Coulby Gunther	F
Courtney Alexander	G
Courtney Fortson	G
Courtney Lee	G
Cozell McQueen	F
Craig Brackins	F
Craig Dykema	F
Craig Hodges	G
Craig Neal	G
Craig Raymond	C
Craig Shelton	F
Craig Smith	F
Craig Spitzer	C
Curtis Borchardt	C
Curtis Jerrells	G
Curtis Kitchen	F
Curtis Perry	F
Curtis Rowe	F
Cuttino Mobley	G
D.C. Wilcutt	G
D.J. Augustin	G
D.J. Kennedy	G,F
Da'Sean Butler	F
Daequan Cook	G
Dahntay Jones	F
DaJuan Summers	F
Dale Davis	F,C
Dale Hamilton	G
Dale Schlueter	C
Dale Wilkinson	F
Dalibor Bagaric	C
Dallas Comegys	C
Damian Lillard	G
Damien Inglis	F
Damien Wilkins	G,F
Damion James	F
Damir Markota	F
Damjan Rudez	F
Damon Jones	G
Damon Stoudamire	G
Dan Dickau	G
Dan Gadzuric	C
Dan Godfread	F
Dan Issel	C
Dan King	F
Dan Kraus	G
Dan Majerle	G,F
Dan McClintock	C
Dan Roundfield	F
Dan Schayes	C
Dan Swartz	F
Dan Tieman	G
Dana Barros	G
Dane Suttle	G
Daniel Anderson	G
Daniel Ewing	G
Daniel Gibson	G
Daniel Santiago	C
Danilo Gallinari	F
Danny Ainge	G
Danny Doyle	F
Danny Ferry	F
Danny Finn	G
Danny Fortson	F,C
Danny Granger	G,F
Danny Green	G,F
Danny Vranes	F
Danny Wagner	G
Danny Young	G
Dante Cunningham	F
Dante Exum	G
Darius Miles	F
Darius Miller	F
Darius Songaila	F
Darnell Hillman	F
Darnell Jackson	F
Darnell Mee	G
Darnell Valentine	G
Darrall Imhoff	C
Darrell Allums	F
Darrell Armstrong	G
Darrell Arthur	F
Darrell Brown	F
Darrell Elston	G
Darrell Griffith	G
Darrell Lockhart	F
Darrell Walker	G
Darren Collison	G
Darren Daye	F
Darren Morningstar	C
Darren Tillis	C
Darrin Hancock	F
Darryl Dawkins	C
Darryl Johnson	G
Darryl Watkins	C
Darvin Ham	G,F
Darwin Cook	G
Dave Batton	C
Dave Bing	G
Dave Budd	F
Dave Corzine	C
Dave Cowens	C
Dave DeBusschere	F
Dave Deutsch	G
Dave Fedor	F
Dave Feitl	C
Dave Gambee	F
Dave Gunther	F
Dave Henderson	G
Dave Hoppen	C
Dave Jamerson	G
Dave Johnson	G
Dave Lattin	F
Dave Magley	F
Dave Meyers	F
Dave Minor	G
Dave Newmark	C
Dave Piontek	F
Dave Popson	C
Dave Robisch	C
Dave Schellhase	G
Dave Scholz	F
Dave Sorenson	F
Dave Stallworth	F
Dave Twardzik	G
Dave Wohl	G
Dave Zeller	G
David Andersen	C
David Benoit	F
David Britton	G
David Burns	G
David Cooke	F
David Greenwood	F
David Harrison	C
David Johnson	G
David Lee	F,C
David Noel	G,F
David Pope	F
David Rivers	G
David Robinson	C
David Thirdkill	F
David Thompson	G
David Vanterpool	G
David Wesley	G
David West	F
David Wingate	G,F
David Wood	F
Dean Garrett	C
Dean Meminger	G
Dean Oliver	G
Dean Tolson	F
DeAndre Jordan	C
Deb Smith	F
Dee Gibson	G
DeJuan Blair	F,C
DeJuan Wheat	G
Del Beshore	G
Delaney Rudd	G
Dell Curry	G,F
Delonte West	G
DeMar DeRozan	G
DeMarcus Cousins	C
DeMarcus Nelson	G
DeMarre Carroll	F
Demetrius Calip	G
Dennis Awtrey	C
Dennis Bell	F
Dennis Boyd	G
Dennis DuVal	G
Dennis Hamilton	F
Dennis Hopson	F
Dennis Johnson	G
Dennis Layton	G
Dennis Nutt	G
Dennis Schroder	G
Dennis Scott	F
Dennis Stewart	F
DeQuan Jones	F
Derek Anderson	G
Derek Fisher	G
Derek Harper	G
Derek Hood	F
Derek Smith	G
Derek Strong	F
DerMarr Johnson	G,F
Dermie O'Connell	G
Deron Williams	G
Derrek Dickey	F
Derrick Brown	F
Derrick Byars	G,F
Derrick Caracter	F
Derrick Chievous	F
Derrick Dial	G
Derrick Favors	F
Derrick Gervin	F
Derrick McKey	F
Derrick Phelps	F
Derrick Rose	G
Derrick Rowland	F
Derrick Williams	F
DeSagana Diop	C
DeShawn Stevenson	G,F
Desmond Ferguson	F
Detlef Schrempf	F
Devean George	F
Devin Brown	G
Devin Durrant	F
Devin Ebanks	F
Devin Harris	G
Devyn Marble	G
Dewayne Dedmon	C
Dewayne Scales	F
Dexter Cambridge	F
Dexter Shouse	F
Diamon Simpson	F
Diante Garrett	G
Dick Barnett	G
Dick Bunt	G
Dick Cunningham	C
Dick Dickey	G
Dick Duckett	G
Dick Eichhorst	G
Dick Farley	G
Dick Fitzgerald	F
Dick Garmaker	G
Dick Gibbs	F
Dick Groat	G
Dick Hemric	F
Dick Holub	C
Dick Knostman	C
Dick McGuire	G
Dick Mehen	F
Dick Miller	F
Dick Murphy	G
Dick O'Keefe	G
Dick Ricketts	F
Dick Rosenthal	F
Dick Schnittker	F
Dick Schulz	F
Dick Shrider	G
Dick Snyder	G
Dick Surhoff	F
Dick Triptow	G
Dick Van Arsdale	G
Dick Wehr	F
Dikembe Mutombo	C
Dillard Crocker	F
Dion Waiters	G
Dionte Christmas	G
Dirk Minniefield	G
Dirk Nowitzki	F
DJ Mbenga	C
DJ Strawberry	G
DJ White	F
Doc Rivers	G
Dolph Schayes	F
Dominic Pressley	G
Dominique Wilkins	F
Don Adams	F
Don Anielak	F
Don Asmonga	G
Don Barksdale	F
Don Bielke	C
Don Boven	F
Don Buse	G
Don Carlson	G
Don Chaney	G
Don Collins	G
Don Eliason	F
Don Ford	F
Don Grate	G
Don Hanrahan	F
Don Henriksen	F
Don Kojis	F
Don Lofgran	F
Don Martin	C
Don May	F
Don Meineke	F
Don Nelson	F
Don Ohl	G
Don Otten	C
Don Putman	G
Don Ray	F
Don Rehfeldt	F
Don Reid	F
Don Savage	F
Don Smith	G
Don Sunderlage	G
Don Williams	G
Donald Ackerman	G
Donald Martin	G
Donald Royal	F
Donald Sloan	G
Donald Smith	F
Donatas Motiejunas	F,C
Donell Taylor	G
Donnie Butcher	G
Donnie Forman	G
Donnie Freeman	G
Donny Marshall	F
Donta Smith	G
Dontae' Jones	F
Donte Greene	F
Dontell Jefferson	G
Donyell Marshall	F
Dorell Wright	F
Dorie Murrey	F
Doron Lamb	G
Double D Davis	F
Doug Bolstorff	G
Doug Collins	G
Doug Edwards	F
Doug Holcomb	F
Doug Kistler	F
Doug Lee	G
Doug McDermott	F
Doug Overton	G
Doug Roth	F
Doug Sims	F
Doug Smith	F
Doyle Parrack	F
Dragan Tarlac	F,C
Draymond Green	F
Drazen Petrovic	G
Drew Barry	G
Drew Gooden	F
Drew Gordon	F,C
Duane Causwell	C
Duane Cooper	G
Duane Ferrell	F
Duane Klueh	G
Duane Washington	G
Dudley Bradley	G
Dwayne Jones	F,C
Dwayne McClain	G
Dwayne Morton	G
Dwayne Polee	F
Dwayne Schintzius	C
Dwayne Washington	G
Dwayne Whitfield	F
Dwight Anderson	G
Dwight Buycks	G
Dwight Howard	C
Dwight Jones	F
Dwight Morrison	F
Dwight Powell	F
Dwight Waller	F
Dwyane Wade	G
Dyron Nix	G
E'Twaun Moore	G
E.C. Coleman	F
Earl Barron	F,C
Earl Boykins	G
Earl Dodd	F
Earl Evans	F
Earl Gardner	F
Earl Jones	C
Earl Lloyd	F
Earl Monroe	G
Earl Shannon	G
Earl Tatum	G
Earl Watson	G
Earl Williams	C
Ed Bartels	F
Ed Beach	F
Ed Biedenbach	G
Ed Burton	F
Ed Conlin	F
Ed Dahler	F
Ed Davis	F
Ed Earle	F
Ed Fleming	G
Ed Gayda	G
Ed Gray	G
Ed Horton	C
Ed Kalafat	C
Ed Kasid	G
Ed Lawrence	C
Ed Leede	G
Ed Macauley	C
Ed Manning	F
Ed Melvin	F
Ed Mikan	C
Ed Nealy	F
Ed Peterson	C
Ed Pinckney	F
Ed Rains	F
Ed Ratleff	G
Ed Sadowski	C
Ed Searcy	F
Ed Smith	F
Ed Stanczak	F
Eddie Basden	G
Eddie Ehlers	G
Eddie House	G
Eddie Hughes	G
Eddie Johnson	G
Eddie Jones	G,F
Eddie Jordan	G
Eddie Mast	F
Eddie Miles	G
Eddie Miller	F
Eddie Owens	F
Eddie Phillips	F
Eddie Robinson	F
Eddielee Wilkins	C
Edgar Jones	F
Edmund Sherod	G
Eduardo Najera	F
Edward Davis	F
Edwin Kachan	G
Efthimios Rentzias	C
Ekpe Udoh	F
Elden Campbell	F,C
Eldo Garrett	G
Elfrid Payton	G
Elgin Baylor	F
Elliot Williams	G
Elmer Behnke	C
Elmo Morgenthaler	C
Elmore Smith	C
Elston Turner	G
Elton Brand	F,C
Elvin Hayes	F
Emanual Davis	G
Emanuel Leaks	C
Emeka Okafor	C
Emmette Bryant	G
Enes Kanter	C
Enoch Olsen	F
Eric Anderson	F
Eric Bledsoe	G
Eric Fernsten	C
Eric Gordon	G
Eric Johnson	G
Eric Leckner	C
Eric Marsh	G
Eric McWilliams	F
Eric Money	G
Eric Montross	C
Eric Moreland	F
Eric Piatkowski	G,F
Eric Riley	C
Eric Snow	G
Eric Washington	G,F
Eric White	F
Erick Barkley	G
Erick Dampier	C
Erick Green	G
Erick Strickland	G
Erik Murphy	F
Ernest Brown	C
Ernie Beck	G
Ernie Calverley	G
Ernie DiGregorio	G
Ernie Grunfeld	G
Ernie Killum	G
Ernie Vandeweghe	F
Ersan Ilyasova	F
Ervin Johnson	C
Erwin Mueller	F
Essie Hollis	F
Esteban Batista	F,C
Estes Parham	F
Etan Thomas	C
Eugene Kennedy	F
Evan Eschmeyer	C
Evan Fournier	G
Evan Turner	G,F
Everette Stephens	G
Evers Burns	F
Fab Melo	C
Felipe Lopez	G,F
Felton Spencer	C
Fennis Dembo	F
Fernando Martin	C
Festus Ezeli	C
Floyd Volker	F
Flynn Robinson	G
Foots Walker	G
Forest Able	G
Forest Weber	C
Forrest McKenzie	F
Fran Curran	G
Francis Crossin	G
Francis Mahoney	F
Francis O'Grady	G
Francisco Garcia	G,F
Frank Brian	G
Frank Fucarino	F
Frank Gates	G
Frank Johnson	G
Frank Kendrick	F
Frank Kornet	F
Frank Kudelka	G
Frank Mangiapane	G
Frank Oleynick	G
Frank Radovich	F
Frank Ramsey	F
Frank Reddout	F
Frank Russell	G
Frank Saul	G
Frank Schade	G
Frank Selvy	G
Frank Williams	G
Frankie Baumholtz	G
Frankie King	G
Frankie Sanders	F
Franklin Edwards	G
Fred Boyd	G
Fred Brown	G
Fred Carter	G
Fred Christ	G
Fred Cofield	G
Fred Diute	G
Fred Foster	F
Fred Hetzel	F
Fred Hilton	G
Fred Hoiberg	G
Fred Jones	G
Fred LaCour	G
Fred Lewis	F
Fred Nagy	G
Fred Paine	F
Fred Saunders	F
Fred Schaus	F
Fred Sheffield	F
Fred Taylor	G
Freddie Crawford	G
Freddie Lewis	G
Freddie Scolari	G
Freeman Williams	G
Frido Frey	F
Gabe Pruitt	G
Gail Goodrich	G
Gal Mekel	G
Gale Bishop	F
Gani Lawal	F
Garfield Heard	F
Garfield Smith	C
Garland O'Shields	G
Garret Siler	C
Garrett Temple	G
Garry Witts	G
Gary Alcorn	C
Gary Alexander	F
Gary Bergen	C
Gary Bradds	F
Gary Brokaw	G
Gary Forbes	F
Gary Freeman	F
Gary Garland	G
Gary Gray	G
Gary Gregor	F
Gary Harris	G
Gary Hill	G
Gary Leonard	C
Gary Melchionni	G
Gary Neal	G
Gary Payton	G
Gary Phillips	G
Gary Plummer	F
Gary Suiter	C
Gary Trent	F
Gary Voce	F
Gary Zeller	G
Geert Hammink	F,C
Gene Banks	F
Gene Berce	G
Gene Conley	C
Gene Dyker	F
Gene Englund	F
Gene Guarilia	F
Gene James	F
Gene Ollrich	G
Gene Rhodes	G
Gene Rock	G
Gene Short	F
Gene Shue	G
Gene Stump	F
Gene Tormohlen	C
Gene Vance	G
Gene Wiley	C
Geoff Huston	G
Geoff Petrie	G
George Blaney	G
George Brown	F
George Carter	F
George Dempsey	G
George Feigenbaum	G
George Gervin	G
George Glamack	C
George Grimshaw	G
George H. Bon Salle	F
George Hill	G
George Johnson	C
George Johnson	C
George Johnson	F
George Kaftan	F
George Karl	G
George King	G
George Lee	F
George Lehmann	G
George Lynch	F
George McCloud	F
George McGinnis	F
George McLeod	F
George Mearns	F
George Mikan	C
George Munroe	G
George Nostrand	C
George Patterson	C
George Pearcy	G
George Ratkovicz	F
George Reynolds	G
George Senesky	G
George Sobek	G
George Thompson	G
George Trapp	F
George Wilson	C
George Yardley	F
Georgi Glouchkov	F
Gerald Brown	G
Gerald Green	G,F
Gerald Henderson	G
Gerald Henderson	G
Gerald Madkins	G
Gerald Paddio	F
Gerald Wallace	F
Gerard Kelly	F
Gerry Calabrese	G
Gerry Ward	G
Gheorghe Muresan	C
Giannis Antetokounmpo	G,F
Giff Roux	F
Gigi Datome	F
Gil McGregor	F
Gilbert Arenas	G
Gino Sovran	F
Glen Davis	F,C
Glen Gondrezick	F
Glen Rice Jr.	G,F
Glen Selbo	F
Glenn Hagan	G
Glenn Hansen	G
Glenn McDonald	F
Glenn Mosley	F
Glenn Robinson	F
Glenn Robinson	G,F
God Shammgod	G
Goebel Ritter	G
Goran Dragic	G
Gordan Giricek	G
Gordon Hayward	F
Gorgui Dieng	C
Gorham Getchell	C
Grady Lewis	F
Grady O'Malley	F
Grant Gondrezick	G
Grant Hill	F
Grant Jerrett	F
Granville Waiters	C
Greg Anderson	F,C
Greg Anthony	G
Greg Ballard	F
Greg Buckner	G
Greg Bunch	F
Greg Butler	C
Greg Deane	G
Greg Dreiling	C
Greg Fillmore	C
Greg Foster	C
Greg Grant	G
Greg Griffin	F
Greg Howard	F
Greg Hyder	F
Greg Jackson	G
Greg Kelser	F
Greg Kite	C
Greg Lee	G
Greg Monroe	F,C
Greg Oden	C
Greg Smith	C
Greg Smith	F
Greg Stiemsma	C
Greg Stokes	F
Greg Sutton	G
Greivis Vasquez	G
Gundars Vetra	F
Gus Bailey	G
Gus Gerard	F
Gus Johnson	F
Gus Williams	G
Gustavo Ayon	F,C
Guy Morgan	G
Guy Rodgers	G
Guy Rucker	F,C
Guy Sparrow	F
Guy Williams	F
Ha Seung-Jin	C
Hakeem Olajuwon	C
Hal Crisler	F
Hal Greer	G
Hal Lear	G
Hal Uplinger	G
Hamed Haddadi	C
Hank Beenders	C
Hank Biasatti	G
Hank DeZonie	F
Hank Finkel	C
Hank Lefkowitz	F
Hank McDowell	F
Hank Rosenstein	F
Hank Zeller	C
Hanno Mottola	F,C
Happy Hairston	F
Harold Brown	G
Harold Ellis	G,F
Harold Fox	G
Harold Jamison	F
Harold Johnson	C
Harold Keeling	G
Harold Kottman	C
Harold Miner	G
Harold Pressley	F
Harrison Barnes	F
Harry Barnes	F
Harry Boykoff	C
Harry Davis	F
Harry Donovan	G
Harry Gallatin	F
Harry Miller	C
Harthorne Wingo	F
Harvey Catchings	C
Harvey Grant	F
Harvey Halbrook	C
Harvey Marlatt	G
Hasheem Thabeet	C
Hassan Whiteside	C
Hedo Turkoglu	F
Henry Akin	C
Henry Bibby	G
Henry Darcey	C
Henry Dickerson	G
Henry Pearcy	G
Henry Sims	C
Henry Turner	G
Henry Ward	G
Herb Krautblatt	G
Herb Scherer	C
Herb White	G
Herb Williams	C
Herbert Hill	F,C
Herm Fuetsch	G
Herm Gilliam	G
Herm Hedderick	G
Herm Klotz	G
Herm Schaefer	G
Herschel Baltimore	F
Hersey Hawkins	G
Hilton Armstrong	F,C
Hollis Copeland	F
Hollis Thompson	G,F
Horace Grant	C
Horace Jenkins	G
Horace McKinney	F
Horace Walker	F
Horacio Llamas	C
Hot Rod Williams	C
Howard Carter	G
Howard Eisley	G
Howard Komives	G
Howard Nathan	G
Howard Porter	F
Howard Tidrick	G
Howard Wood	F
Howard Wright	F
Howie Carl	G
Howie Dallmar	F
Howie Janotta	F
Howie Jolliff	F
Howie Montgomery	F
Howie Rader	G
Howie Schultz	F
Howie Shannon	G
Hub Reed	C
Hubert Davis	G
Hubie White	G
Ian Clark	G
Ian Lockhart	F
Ian Mahinmi	C
Igor Rakocevic	G
Iman Shumpert	G
Ira Newble	G,F
Ira Terrell	F
Irv Bemoras	F
Irv Kiffin	F
Irv Rothenberg	C
Irv Torgoff	F
Irving Thomas	F
Isaac Stallworth	F
Isaiah Canaan	G
Isaiah Morris	F
Isaiah Thomas	G
Isaiah Wilson	G
Ish Smith	G
Isiah Thomas	G
Ivan Johnson	F
Ivano Newbill	C
J.R. Bremer	G
J.R. Giddens	G
J.R. Henderson	F
J.R. Smith	G,F
Jabari Parker	F
Jabari Smith	C
Jack Burmaster	G
Jack Coleman	F
Jack Cotton	F
Jack Dwan	F
Jack Eskridge	C
Jack Foley	F
Jack Garfinkel	G
Jack George	G
Jack Givens	F
Jack Hewson	F
Jack Kerris	F
Jack Kiley	G
Jack Maddox	F
Jack Marin	F
Jack McCloskey	G
Jack McMahon	G
Jack Molinas	F
Jack Nichols	C
Jack Parkinson	G
Jack Parr	C
Jack Phelan	F
Jack Rocker	C
Jack Sikma	C
Jack Smiley	G
Jack Stephens	G
Jack Tingle	F
Jack Toomay	C
Jack Turner	G
Jack Turner	G
Jack Twyman	F
Jackie Butler	C
Jackie Dinkins	F
Jackie Moore	F
Jackie Moreland	F
Jackie Ridgle	G
Jackie Robinson	F
Jacky Dorsey	F
Jacque Vaughn	G
Jae Crowder	F
JaJuan Johnson	F
JaKarr Sampson	F
Jake Bornheimer	F
Jake Carter	F
Jake Fendley	G
Jake Ford	G
Jake Jones	G
Jake Pelkington	C
Jake Tsakalidis	C
Jake Voskuhl	C
Jalen Rose	G,F
Jamaal Franklin	G
Jamaal Magloire	C
Jamaal Wilkes	F
Jamal Crawford	G
Jamal Mashburn	F
Jamal Sampson	F,C
Jamario Moon	F
Jameer Nelson	G
Jamel Thomas	F
James Anderson	G,F
James Augustine	F
James Bailey	F
James Blackwell	G
James Collins	G
James Davis	C
James Donaldson	C
James Edwards	C
James Ennis	F
James Harden	G
James Hardy	F
James Johnson	F
James Jones	F
James Owens	G
James Posey	F
James Scott	F
James Silas	G
James Singleton	F
James Southerland	F
James White	G,F
James Wilkes	F
James Worthy	F
James Young	G,F
Jamesearl Ray	F
Jamie Feick	F
Jamie Waller	F
Jan Van Breda Kolff	F
Jan Vesely	F
Jannero Pargo	G
Jared Cunningham	G
Jared Dudley	G
Jared Jeffries	F
Jared Reiner	C
Jared Sullinger	F
Jaren Jackson	G
Jarnell Stokes	F,C
Jarrett Jack	G
Jarvis Hayes	F
Jarvis Varnado	F,C
Jason Caffey	F
Jason Collier	C
Jason Collins	C
Jason Kidd	G
Jason Lawson	C
Jason Maxiell	F
Jason Richardson	G
Jason Sasser	F
Jason Smith	F,C
Jason Terry	G
Jason Thompson	F
JaVale McGee	C
Javaris Crittenton	G
Jawann Oldham	C
Jay Arnette	G
Jay Carty	F
Jay Edwards	F
Jay Guidinger	C
Jay Humphries	G
Jay Miller	F
Jay Murphy	F
Jay Taylor	F
Jay Vincent	F
Jay Williams	G
Jeff Adrien	F
Jeff Ayres	F,C
Jeff Cook	F
Jeff Cross	F
Jeff Foster	F,C
Jeff Grayer	G
Jeff Green	F
Jeff Halliburton	G
Jeff Hornacek	G
Jeff Judkins	G
Jeff Lamp	G
Jeff Lebo	F
Jeff Martin	G
Jeff Mullins	G
Jeff Ruland	C
Jeff Sanders	F
Jeff Slade	F
Jeff Taylor	G
Jeff Taylor	F
Jeff Teague	G
Jeff Trepagnier	G
Jeff Turner	F
Jeff Webb	G
Jeff Webster	F
Jeff Wilkins	C
Jeff Withey	C
Jeffrey Crompton	C
Jerald Honeycutt	G,F
Jerami Grant	F
Jerel McNeal	G
Jeremy Evans	F
Jeremy Lamb	G
Jeremy Lin	G
Jeremy Richardson	G,F
Jeremy Tyler	F
Jermaine Jackson	G
Jermaine O'Neal	F,C
Jermareo Davidson	F
Jerome Allen	G
Jerome Anderson	G
Jerome Beasley	F
Jerome Dyson	G
Jerome Harmon	G
Jerome Henderson	F
Jerome James	C
Jerome Jordan	C
Jerome Lane	F
Jerome Whitehead	C
Jerome Williams	F,C
Jerrod Mustaf	F
Jerry Baskerville	F
Jerry Bird	F
Jerry Chambers	F
Jerry Eaves	G
Jerry Fleishman	G
Jerry Fowler	C
Jerry Greenspan	F
Jerry Grote	G
Jerry Harkness	G
Jerry Lucas	F
Jerry Nagel	G
Jerry Paulson	G
Jerry Reynolds	G
Jerry Rullo	G
Jerry Sichting	G
Jerry Sloan	G
Jerry Stackhouse	F
Jerry West	G
Jerryd Bayless	G
Jeryl Sasser	G
Jesse Arnelle	F
Jesse Branson	F
Jesse Dark	G
Jim Ard	C
Jim Baechtold	F
Jim Barnes	C
Jim Barnett	G
Jim Bostic	F
Jim Brasco	G
Jim Brewer	F
Jim Brogan	G
Jim Browne	C
Jim Burns	G
Jim Caldwell	C
Jim Chones	C
Jim Cleamons	G
Jim Creighton	F
Jim Davis	C
Jim Eakins	C
Jim Farmer	F
Jim Fox	C
Jim Fritsche	C
Jim Garvin	F
Jim Grandholm	C
Jim Holstein	F
Jim Jackson	G,F
Jim Johnstone	C
Jim King	G
Jim Krebs	C
Jim Lampley	F
Jim Les	G
Jim Loscutoff	F
Jim Luisi	G
Jim Marsh	F
Jim McDaniels	C
Jim McElroy	G
Jim McMillian	F
Jim Mooney	F
Jim Neal	C
Jim Nolan	C
Jim Owens	F
Jim Palmer	F
Jim Paxson	G
Jim Paxson	G
Jim Petersen	F
Jim Phelan	G
Jim Pollard	F
Jim Price	G
Jim Ray	G
Jim Reid	C
Jim Riffey	F
Jim Rowinski	C
Jim Seminoff	G
Jim Slaughter	C
Jim Smith	F
Jim Spanarkel	G
Jim Springer	C
Jim Spruill	F
Jim Thomas	G
Jim Tucker	F
Jim Walsh	F
Jim Ware	F
Jim Washington	F
Jim Zoet	C
Jimmer Fredette	G
Jimmy Butler	G,F
Jimmy Collins	G
Jimmy Darden	G
Jimmy Darrow	G
Jimmy Jones	G
Jimmy King	G
Jimmy Walker	G
Jiri Welsch	F
JJ Hickson	F,C
JJ Redick	G
Joakim Noah	C
Joao Vianna	F
Joby Wright	F
Jodie Meeks	G
Joe Alexander	F
Joe Arlauckas	F
Joe Barry Carroll	C
Joe Binion	F
Joe Bradley	G
Joe Bryant	F
Joe Buckhalter	F
Joe Caldwell	F
Joe Colone	F
Joe Cooke	G
Joe Cooper	C
Joe Crawford	G
Joe Crispin	G
Joe Dolhon	G
Joe Dumars	G
Joe Ellis	F
Joe Fabel	F
Joe Fulks	F
Joe Graboski	F
Joe Harris	G
Joe Holland	F
Joe Holup	F
Joe Hutton	G
Joe Ingles	G,F
Joe Johnson	G,F
Joe Kennedy	F
Joe Kopicki	F
Joe McNamee	C
Joe Meriweather	C
Joe Mullaney	G
Joe Pace	C
Joe Reaves	F
Joe Roberts	F
Joe Ruklick	F
Joe Smith	F,C
Joe Smyth	F
Joe Strawder	C
Joe Thomas	F
Joel Anthony	C
Joel Embiid	C
Joel Freeland	F,C
Joel Ingram	F
Joel Kramer	F
Joel Przybilla	C
Joey Dorsey	F,C
Joey Graham	F
Joey Hassett	G
Johan Petro	C
John Abramovic	F
John Amaechi	F,C
John Arthurs	G
John Austin	G
John Bagley	G
John Barber	F
John Barnhill	G
John Barr	F
John Battle	G
John Block	F
John Brisker	F
John Brown	F
John Celestand	G
John Chaney	F
John Clemens	F
John Coughran	F
John Cox	G
John Dillon	F
John Douglas	G
John Drew	F
John Duren	G
John Edwards	C
John Fairchild	F
John Garris	F
John Gianelli	C
John Greig	F
John Hargis	G
John Havlicek	F
John Henson	F,C
John Hummer	F
John Janisch	F
John Jenkins	G
John Johnson	F
John Kuester	G
John Lambert	C
John Laskowski	G
John Long	G
John Lucas	G
John Lucas III	G
John Mahnken	C
John Mandic	F
John McConathy	F
John McCullough	G
John Mengelt	G
John Mills	C
John Morton	F
John Murphy	F
John Niemiera	G
John O'Boyle	G
John Olive	F
John Palmer	F
John Paxson	G
John Pilch	F
John Pinone	F
John Pritchard	C
John Rennicke	G
John Richter	F
John Roche	G
John Rudd	F
John Rudometkin	F
John Salley	F,C
John Salmons	F
John Schweitz	G
John Shasky	C
John Shumate	F
John Starks	G
John Stockton	G
John Stroeder	F
John Stroud	F
John Thomas	C
John Thompson	F
John Trapp	F
John Tresvant	F
John Tschogl	F
John Turner	F
John Vallely	G
John W. Hazen	G
John Wall	G
John Wallace	F
John Wetzel	G
John Williams	F
John Williamson	G
John Windsor	F
Johnny Bach	F
Johnny Baum	F
Johnny Cox	G
Johnny Davis	G
Johnny Dawkins	G
Johnny Egan	G
Johnny Green	F
Johnny High	G
Johnny Horan	F
Johnny Jones	F
Johnny Jorgensen	G
Johnny Kerr	C
Johnny Logan	G
Johnny Macknowski	G
Johnny McCarthy	G
Johnny Moore	G
Johnny Neumann	G
Johnny Newman	F
Johnny Norlander	F
Johnny O'Bryant	F
Johnny Oldham	G
Johnny Orr	F
Johnny Payak	G
Johnny Rogers	F
Johnny Simmons	G
Johnny Taylor	F
Johnny Warren	G
Jojo English	G
Jojo White	G
Jon Brockman	F
Jon Koncak	C
Jon Leuer	F
Jon McGlocklin	G
Jon Sundvold	G
Jonas Jerebko	F
Jonas Valanciunas	C
Jonathan Bender	F
Jonathan Kerner	C
Jonny Flynn	G
Jordan Adams	G
Jordan Clarkson	G
Jordan Crawford	G
Jordan Farmar	G
Jordan Hamilton	G,F
Jordan Hill	C
Jordan Williams	C
Jorge Gutierrez	G
Jose Calderon	G
Jose Juan Barea	G
Jose Ortiz	F
Jose Slaughter	G
Joseph Forte	G
Joseph Reiser	G
Josh Akognon	G
Josh Boone	F,C
Josh Grant	F
Josh Harrellson	F,C
Josh McRoberts	F
Josh Powell	F
Josh Smith	F
Jrue Holiday	G
Juan Dixon	G
Juan Sanchez	G
Juaquin Hawkins	F
Jud Buechler	G,F
Julian Wright	F
Julius Erving	F
Julius Nwosu	F
Julius Randle	F
Julyan Stone	G
Jumaine Jones	F
Junior Bridgeman	F
Junior Burrough	F
Junior Harrington	G
Justin Hamilton	C
Justin Harper	F,C
Justin Holiday	G
Justus Thigpen	G
Jusuf Nurkic	C
Juwan Howard	F
K.C. Jones	G
Kalin Lucas	G
Kannard Johnson	F
Kareem Abdul-Jabbar	C
Karl Malone	F
Kasib Powell	F
Kawhi Leonard	F
Kebu Stewart	F
Keith Askins	G,F
Keith Bogans	G,F
Keith Booth	F
Keith Closs	C
Keith Edmonson	G
Keith Erickson	F
Keith Herron	G
Keith Jennings	G
Keith Lee	F
Keith McCord	G
Keith McLeod	G
Keith Owens	F
Keith Smart	G
Keith Smith	G
Keith Starr	G
Keith Van Horn	F
Kelenna Azubuike	G
Kelly McCarty	G,F
Kelly Olynyk	F,C
Kelly Tripucka	F
Kelvin Cato	C
Kelvin Ransey	G
Kelvin Upshaw	G
Kemba Walker	G
Ken Austin	F
Ken Bannister	F
Ken Boyd	F
Ken Charles	G
Ken Durrett	F
Ken Green	F
Ken Johnson	F,C
Ken Johnson	F
Ken Mayfield	G
Ken McBride	F
Ken Menke	G
Ken Murray	G
Ken Rohloff	G
Ken Sears	F
Ken Wilburn	F
Kendall Marshall	G
Kendrick Perkins	C
Kennard Winchester	F
Kenneth Faried	F
Kenny Battle	G
Kenny Carr	F
Kenny Dennard	F
Kenny Fields	F
Kenny Gattison	F
Kenny Green	G
Kenny Hasbrouck	G
Kenny Higgs	G
Kenny McIntosh	F
Kenny Natt	G
Kenny Payne	F
Kenny Rollins	G
Kenny Sailors	G
Kenny Satterfield	G
Kenny Smith	G
Kenny Walker	F
Kenny Williams	F
Kent Bazemore	G
Kent Benson	C
Kent Edelin	F
Kentavious Caldwell-Pope	G
Kenyon Martin	F
Keon Clark	F,C
Kermit Washington	F
Kevin Brooks	F
Kevin Burleson	G
Kevin Duckworth	C
Kevin Durant	F
Kevin Edwards	G
Kevin Garnett	F,C
Kevin Grevey	G
Kevin Henderson	G
Kevin Johnson	G
Kevin Jones	F
Kevin Kunnert	C
Kevin Loder	F
Kevin Loughery	G
Kevin Love	F
Kevin Lynch	F
Kevin Martin	G
Kevin McHale	F
Kevin McKenna	F
Kevin Murphy	G
Kevin O'Shea	G
Kevin Ollie	G
Kevin Porter	G
Kevin Pritchard	G
Kevin Restani	F
Kevin Seraphin	C
Kevin Stacom	G
Kevin Thompson	C
Kevin Williams	G
Kevin Willis	F,C
Keyon Dooling	G
Khalid El-Amin	G
Khris Middleton	F
Kiki Vandeweghe	F
Kim Anderson	F
Kim English	G
Kim Hughes	C
Kirk Haston	F
Kirk Hinrich	G
Kirk Snyder	G,F
Kiwane Garris	G
KJ McDaniels	G,F
Klay Thompson	G
Kobe Bryant	G
Kornel David	F
Kosta Koufos	C
Kosta Perovic	C
Kostas Papanikolaou	F
Kris Humphries	F
Kris Joseph	F
Kurk Lee	G
Kurt Nimphius	C
Kurt Rambis	F
Kwame Brown	C
Kyle Anderson	F
Kyle Korver	G
Kyle Lowry	G
Kyle Macy	G
Kyle O'Quinn	F,C
Kyle Singler	F
Kyrie Irving	G
Kyrylo Fesenko	C
Labradford Smith	F
Lafayette Lever	G
Lamar Green	F
Lamar Odom	F
LaMarcus Aldridge	F
Lamond Murray	F
Lamont Strothers	G
Lanard Copeland	F
Lancaster Gordon	G
Lance Allred	C
Lance Blanks	G
Lance Stephenson	G
Lance Thomas	F
Landry Fields	G,F
LaPhonso Ellis	F
Larry Bird	F
Larry Cannon	G
Larry Comley	G
Larry Costello	G
Larry Demic	F
Larry Drew	G
Larry Fogle	G
Larry Foust	C
Larry Friend	G
Larry Hennessy	G
Larry Johnson	F
Larry Johnson	G
Larry Jones	G
Larry Kenon	F
Larry McNeill	F
Larry Micheaux	F
Larry Mikan	F
Larry Moffett	F
Larry Nance	F
Larry Robinson	G
Larry Sanders	C
Larry Siegfried	G
Larry Smith	F
Larry Spriggs	F
Larry Staverman	F
Larry Steele	G
Larry Stewart	F
Larry Sykes	F
Larry Wright	G
Lars Hansen	C
Larue Martin	C
Latrell Sprewell	G
Lavor Postell	G,F
Lavoy Allen	F,C
Lawrence Boston	F
Lawrence Funderburke	F
Lawrence Roberts	F
Lazaro Borrell	F
Leandro Barbosa	G
LeBron James	F
Ledell Eackles	G
Lee Johnson	F
Lee Knorek	C
Lee Robbins	F
Lee Shaffer	F
Lee Winfield	G
Len Chappell	F
Len Elmore	C
Len Kosmalski	C
Lennie Rosenbluth	F
Lenny Wilkens	G
Leo Barnhorst	F
Leo Gottlieb	G
Leo Katkaveck	G
Leo Klier	G
Leo Kubiak	G
Leo Mogus	F
Leo Rautins	F
Leon Benbow	G
Leon Blevins	G
Leon Brown	F
Leon Douglas	C
Leon Powe	F
Leon Smith	F
Leon Wood	G
Leonard Gray	F
Leonard Taylor	F
LeRon Ellis	C
Leroy Chollet	F
Leroy Combs	F
Leroy Ellis	F
Les Hunter	F
Les Jepsen	G
Les Pugh	C
Lester Conner	G
Lester Hudson	G
Levi Fontaine	G
Lew Hitch	F
Lewis Brown	C
Lewis Lloyd	G
Linas Kleiza	F
Lindsay Hairston	F
Linton Johnson	F
Linton Townes	F
Lionel Chalmers	G
Lionel Hollins	G
Lionel Malamed	G
Lionel Simmons	F
Lloyd Dove	F
Lloyd Neal	F
Lloyd Walton	G
Log Vander Velden	F
Lonnie Eggleston	G
Lonnie Shelton	F
Lonny Baxter	F
Loren Meyer	F,C
Loren Woods	C
Lorenzen Wright	F,C
Lorenzo Charles	F
Lorenzo Romar	G
Lou Amundson	F
Lou Dampier	G
Lou Hudson	F
Lou Roe	F
Lou Spicer	F
Lou Tsioropoulos	F
Louie Nelson	G
Louis Orr	F
Louis Williams	G
Lowes Moore	G
Loy Petersen	G
Loy Vaught	F,C
Luc Mbah a Moute	F
Lucas Nogueira	C
Lucian Whitaker	G
Lucious Jackson	F
Lucius Allen	G
Luis Flores	G
Luis Scola	F
Luke Babbitt	F
Luke Harangody	F
Luke Rackley	C
Luke Ridnour	G
Luke Schenscher	C
Luke Walton	F
Luke Witte	C
Luol Deng	F
Luther Burden	G
Luther Green	F
Luther Wright	C
Lynbert Johnson	F
Lynn Greer	G
M.L. Carr	F
Mac Otten	F
Maceo Baston	F
Maciej Lampe	F
Mack Calvin	G
Magic Johnson	G,F
Magnum Rolle	F
Mahmoud Abdul-Rauf	G
Major Jones	F
Makhtar N'Diaye	F
Mal Graham	G
Malcolm Lee	G
Malcolm Mackey	F
Malik Allen	F
Malik Hairston	G
Malik Rose	F
Malik Sealy	G,F
Mamadou N'diaye	C
Manu Ginobili	G
Manute Bol	C
Marc Gasol	C
Marc Iavaroni	F
Marc Jackson	F
Marcin Gortat	C
Marco Belinelli	G
Marcus Banks	G
Marcus Camby	F,C
Marcus Cousin	F
Marcus Liberty	F
Marcus Morris	F
Marcus Smart	G
Marcus Thornton	G
Marcus Webb	F
Marcus Williams	G
Marcus Williams	G
Mardy Collins	G
Mario Bennett	F,C
Mario Chalmers	G
Mario Elie	G,F
Mario Kasun	C
Mario West	G
Marion Cluggish	C
Mark Acres	C
Mark Aguirre	F
Mark Alarie	F
Mark Blount	F,C
Mark Bradtke	C
Mark Bryant	F
Mark Crow	F
Mark Davis	G,F
Mark Davis	F
Mark Eaton	C
Mark Jackson	G
Mark Jones	G
Mark Landsberger	F
Mark Madsen	F
Mark McNamara	C
Mark Minor	F
Mark Olberding	F
Mark Pope	F,C
Mark Price	G
Mark Radford	G
Mark Randall	F
Mark Sibley	G
Mark Wade	G
Mark Workman	C
Markel Brown	G
Markieff Morris	F
Marko Jaric	G
Marko Todorovich	F
Marlon Maxey	F
Marlon Redmond	G
Marques Bragg	F
Marques Johnson	F
Marquis Daniels	F
Marquis Teague	G
Marqus Blakely	F
Marreese Speights	F,C
Marshall Hawkins	F
Marshall Rogers	G
MarShon Brooks	G
Martell Webster	G,F
Martin Lewis	F
Martin Muursepp	F
Martin Nessley	F
Marty Byrnes	F
Marty Passaglia	G
Martynas Andriuskevicius	C
Marv Roberts	F
Marv Schatzman	F
Marv Winkler	G
Marvin Barnes	F
Marvin Webster	C
Marvin Williams	F
Mason Plumlee	F,C
Matt Barnes	F
Matt Bonner	F,C
Matt Bullard	F
Matt Guokas	G
Matt Guokas	G
Matt Harpring	F
Matt Mazza	F
Matt Othick	G
Matt Wenstrom	C
Matt Zunic	G
Matthew Dellavedova	G
Matthew Hickey	G
Maurice Carter	G
Maurice Cheeks	G
Maurice Evans	G,F
Maurice Harkless	F
Maurice Lucas	F
Maurice Stokes	F
Maury King	G
Max Morris	F
Max Zaslofsky	G
Mccoy McLemore	F
Mckinley Singleton	F
Medford Park	G
Mel Bennett	F
Mel Counts	C
Mel Daniels	C
Mel Davis	F
Mel Gibson	G
Mel Hirsch	G
Mel Hutchins	F
Mel McCants	F
Mel McGaha	G
Mel Nowell	G
Mel Payton	G
Mel Peterson	G
Mel Riebe	G
Mel Thurston	G
Mel Turpin	C
Melvin Booker	G
Melvin Ely	F,C
Melvin Newbern	G
Meyers Leonard	C
Michael Adams	G
Michael Anderson	G
Michael Ansley	F
Michael Beasley	F
Michael Bradley	F
Michael Brooks	F
Michael Carter-Williams	G
Michael Cooper	G
Michael Davis	F
Michael Dickerson	G
Michael Doleac	C
Michael Finley	G,F
Michael Holton	G
Michael Jackson	G
Michael Jordan	G
Michael Kearns	G
Michael Kidd-Gilchrist	F
Michael Olowokandi	C
Michael Redd	G
Michael Ruffin	F,C
Michael Smith	F
Michael Smith	G
Michael Stewart	C
Michael Sweetney	F
Michael Wallace	G
Michael Wiley	F
Michael Young	G
Micheal Ray Richardson	G
Mickael Gelabale	F
Mickael Pietrus	F
Mickell Gladness	C
Mickey Dillard	G
Mickey Johnson	F
Mickey Rottner	G
Mike Bantom	F
Mike Barr	G
Mike Bibby	G
Mike Bloom	C
Mike Bratz	G
Mike Brittain	C
Mike Brown	F,C
Mike Bytzura	F
Mike Champion	F
Mike Conley	G
Mike D'Antoni	G
Mike Davis	G
Mike Dunleavy	F
Mike Dunleavy	G
Mike Evans	G
Mike Farmer	F
Mike Flynn	G
Mike Gale	G
Mike Gibson	F
Mike Glenn	G
Mike Gminski	C
Mike Green	C
Mike Hall	F
Mike Harper	C
Mike Higgins	F
Mike Iuzzolino	G
Mike James	G
Mike Lynn	F
Mike Macaluso	F
Mike McCarron	G
Mike McGee	F
Mike Miller	F
Mike Mitchell	F
Mike Morrison	G
Mike Muscala	F,C
Mike Newlin	G
Mike Niles	F
Mike Novak	C
Mike O'Koren	F
Mike O'Neill	F
Mike Peplowski	C
Mike Phelps	G
Mike Price	G
Mike Ratliff	C
Mike Riordan	F
Mike Sanders	F
Mike Scott	F
Mike Silliman	F
Mike Smith	F
Mike Smrek	C
Mike Sojourner	C
Mike Taylor	G
Mike Williams	G
Mike Wilson	G
Mike Woodson	G
Mikki Moore	F,C
Mile Ilic	C
Miles Plumlee	F,C
Miles Simon	G
Milo Komenich	C
Milos Babic	C
Milt Palacio	G
Milt Schoon	C
Milt Wagner	G
Milt Williams	G
Miroslav Raduljica	C
Mirsad Turkcan	F
Mirza Teletovic	F
Mitch Kupchak	F
Mitch McGary	F
Mitch Richmond	G
Mitchell Anderson	F
Mitchell Butler	G
Mitchell Wiggins	G
Mo Howard	G
Mo Martin	G
Mo Williams	G
Moe Becker	G
Moe Radovich	G
Monta Ellis	G
Monte Towe	G
Monti Davis	F
Monty Williams	F
Moochie Norris	G
Morlon Wiley	G
Morris Almond	G
Moses Malone	C
Mouhamed Sene	C
Murray Mitchell	C
Murray Wier	G
Mychal Thompson	C
Myles Patrick	F
Myron Brown	F
Myron Jackson	G
Nando De Colo	G
Nat Clifton	C
Nat Frankel	F
Nat Militzok	F
Nate Archibald	G
Nate Blackwell	G
Nate Bowman	C
Nate DeLong	C
Nate Driggers	G,F
Nate Hawthorne	G
Nate Huffman	C
Nate Johnston	C
Nate McMillan	G,F
Nate Robinson	G
Nate Thurmond	C
Nate Williams	G
Nate Wolters	G
Nathan Jawai	F
Nazr Mohammed	C
Ndudi Ebi	F
Neal Walk	C
Ned Endress	F
Negele Knight	G
Neil Johnson	F
Neil Johnston	C
Nelson Bobb	G
Nemanja Nedovic	G
Nenad Krstic	C
Nene	F,C
Nerlens Noel	F,C
Nick Anderson	G,F
Nick Calathes	G
Nick Collison	F
Nick Fazekas	F
Nick Johnson	G
Nick Jones	G
Nick Mantis	G
Nick Shaback	G
Nick Van Exel	G
Nick Vanos	C
Nick Weatherspoon	F
Nick Young	G,F
Nicolas Batum	F
Nik Stauskas	G
Nikita Wilson	F
Nikola Mirotic	F
Nikola Pekovic	C
Nikola Vucevic	C
Nikoloz Tskitishvili	F
Noah Vonleh	F
Noble Jorgensen	C
Noel Felix	F
Nolan Smith	G
Norm Baker	G
Norm Cook	F
Norm Grekin	F
Norm Mager	F
Norm Nixon	G
Norm Stewart	F
Norm Swanson	F
Norm Van Lier	G
Norman Black	G
Norman Glick	F
Norman Richardson	G
Norris Cole	G
Norris Coleman	F
Norton Barnhill	G
O.J. Mayo	G
Odie Spears	F
Odis Allison	F
Ognjen Kuzmic	C
Oleksiy Pecherov	F,C
Oliver Lafayette	G
Oliver Miller	C
Oliver Robinson	G
Ollie Johnson	F
Ollie Mack	G
Omar Cook	G
Omer Asik	C
Omri Casspi	F
Orlando Graham	F
Orlando Woolridge	F
Oscar Robertson	G
Oscar Torres	G,F
Ossie Schectman	G
Othell Wilson	G
Othella Harrington	F,C
Othyus Jeffers	G,F
Otis Birdsong	G
Otis Howard	F
Otis Smith	F
Otis Thorpe	F,C
Otto Moore	C
Otto Porter	F
Otto Schnellbacher	F
Owen Wells	F
Ozell Jones	C
P.J. Brown	F,C
Pablo Prigioni	G
Pace Mannion	G
Pape Sow	F
Pape Sy	G,F
Pat Burke	F,C
Pat Cummings	C
Pat Dunn	G
Pat Durham	F
Pat Frink	G
Pat Garrity	F
Pat Riley	G
Patric Young	F,C
Patrick Beverley	G
Patrick Eddie	C
Patrick Ewing	C
Patrick Ewing Jr.	F
Patrick O'Bryant	C
Patrick Patterson	F
Patty Mills	G
Pau Gasol	F,C
Paul Arizin	F
Paul Armstrong	G
Paul Cloyd	G
Paul Dawkins	F
Paul George	G,F
Paul Gordon	F
Paul Graham	G
Paul Griffin	F
Paul Hogue	C
Paul Huston	F
Paul Long	G
Paul McConnell	G
Paul McCracken	G
Paul McPherson	G
Paul Millsap	F
Paul Mokeski	C
Paul Napolitano	G
Paul Neumann	G
Paul Noel	F
Paul Nolen	C
Paul Pierce	F
Paul Pressey	G
Paul Ruffner	C
Paul Seymour	G
Paul Shirley	F
Paul Silas	F
Paul Stovall	F
Paul Thompson	G
Paul Walther	G
Paul Westphal	G
Peja Stojakovic	F
Pero Antic	F,C
Perry Jones	F
Perry Moss	G
Perry Warbington	G
Perry Young	G
Pete Brennan	F
Pete Chilcutt	F
Pete Cross	C
Pete Lalich	F
Pete Maravich	G
Pete Williams	F
Peter Maravich	G
Peter Thibeaux	F
Peter Verhoeven	F
Petur Gudmundsson	C
Peyton Siva	G
Phil Bond	G
Phil Chenier	G
Phil Farbman	F
Phil Ford	G
Phil Hankinson	F
Phil Hicks	F
Phil Hubbard	F
Phil Jackson	F
Phil Jordon	C
Phil Lumpkin	G
Phil Martin	G
Phil Pressey	G
Phil Rollins	G
Phil Sellers	F
Phil Smith	G
Phil Walker	G
Phil Zevenbergen	F
PJ Hairston	G,F
PJ Tucker	G,F
Plummer Lott	F
Pooh Jeter	G
Popeye Jones	F
Porter Meriwether	G
Predrag Drobnjak	C
Predrag Savovic	G
Price Brookfield	F
Priest Lauderdale	C
Primoz Brezec	C
Purvis Short	F
Quentin Richardson	F
Quincy Acy	F
Quincy Douby	G
Quincy Miller	F
Quincy Pondexter	G,F
Quinn Buckner	G
Quintin Dailey	G
Qyntel Woods	G,F
Rabbit Walthour	G
Radisav Curcic	C
Raef LaFrentz	F,C
Rafael Addison	F
Rafael Araujo	C
Rafer Alston	G
Raja Bell	G
Rajon Rondo	G
Ralph Beard	G
Ralph Davis	G
Ralph Drollinger	C
Ralph Hamilton	G
Ralph Jackson	G
Ralph Kaplowitz	G
Ralph Lewis	G
Ralph Ogden	F
Ralph Polson	F
Ralph Sampson	C
Ralph Siewert	C
Ralph Simpson	G
Ralph Wells	G
Ramon Rivas	F
Ramon Sessions	G
Randolph Keys	F
Randolph Morris	C
Randy Allen	F
Randy Breuer	C
Randy Brown	G
Randy Denton	C
Randy Foye	G
Randy Livingston	G
Randy Smith	G
Randy White	F
Randy Wittman	G
Randy Woods	G
Rashad McCants	G
Rashard Lewis	F
Rasho Nesterovic	C
Rastko Cvetkovic	C
Rasual Butler	F
Ratko Varda	C
Rawle Marshall	G,F
Ray Allen	G
Ray Blume	G
Ray Corley	G
Ray Ellefson	C
Ray Epps	F
Ray Felix	C
Ray Kuka	F
Ray Lumpp	G
Ray McCallum	G
Ray Owes	F
Ray Radziszewski	F
Ray Ragelis	F
Ray Ramsey	G
Ray Scott	F
Ray Tolbert	F
Ray Wertis	G
Ray Williams	G
Raymond Brown	F
Raymond Felton	G
Raymond Townsend	G
Red Holzman	G
Red Rocha	C
Reggie Bullock	G
Reggie Carter	G
Reggie Evans	F
Reggie Geary	G
Reggie Hanson	F
Reggie Harding	C
Reggie Jackson	G
Reggie Johnson	F
Reggie King	F
Reggie Lewis	G
Reggie Miller	G
Reggie Slater	F
Reggie Smith	F
Reggie Theus	G
Rex Morgan	G
Rich Johnson	C
Rich Jones	F
Rich Kelley	C
Rich King	C
Rich Laurel	G
Rich Niemann	C
Rich Rinaldi	G
Rich Yonakor	F
Richard Anderson	F
Richard Atha	G
Richard Coffey	G
Richard Dumas	F
Richard Hamilton	G
Richard Jefferson	F
Richard Manning	C
Richard Morton	F
Richard Petruska	C
Richard Rellford	F
Richard Washington	F
Richie Guerin	G
Richie Regan	G
Rick Adelman	G
Rick Barry	F
Rick Brunson	G
Rick Calloway	G
Rick Carlisle	G
Rick Fox	F
Rick Mahorn	F
Rick Roberson	C
Rick Robey	C
Rick Weitzman	G
Rick Wilson	G
Rickey Brown	C
Rickey Green	G
Rickey Williams	G
Rickie Winslow	F
Ricky Berry	F
Ricky Blanton	F
Ricky Grace	G
Ricky Ledo	G
Ricky Pierce	G
Ricky Rubio	G
Ricky Sobers	G
Ricky Wilson	G
Rik Smits	C
Rob Kurz	F
Rob Rensberger	F
Rob Williams	G
Robbie Hummel	F
Robert Archibald	F
Robert Churchwell	F
Robert Covington	F
Robert Hawkins	G
Robert Horry	F,C
Robert Lock	F
Robert Nordmann	C
Robert Parish	C
Robert Reid	F
Robert Rose	F
Robert Sacre	C
Robert Smith	G
Robert Swift	C
Robert Traylor	F,C
Robert Vaden	G,F
Robert Werdann	C
Robert Zawoluk	F
Robin Jones	C
Robin Lopez	C
Rock Lee	C
Rod Derline	G
Rod Foster	G
Rod Freeman	F
Rod Higgins	F
Rod Hundley	G
Rod Knowles	C
Rod Thorn	G
Rodney Buford	G,F
Rodney Hood	G,F
Rodney McCray	F
Rodney Monroe	G
Rodney Rogers	F
Rodney Stuckey	G
Rodney White	F
Rodrigue Beaubois	G
Roger Brown	C
Roger Burkman	G
Roger Jorgensen	C
Roger Phegley	G
Roger Strickland	F
Roland Taylor	G
Roland West	G
Rolando Blackman	G
Rolando Ferreira	F
Rollen Hans	G
Rollie Seltz	G
Ron Anderson	F
Ron Behagen	F
Ron Bonham	F
Ron Boone	G
Ron Brewer	G
Ron Carter	G
Ron Cavenall	C
Ron Crevier	C
Ron Davis	G
Ron Feiereisel	G
Ron Filipek	F
Ron Harper	G
Ron Horn	F
Ron Johnson	F
Ron Knight	F
Ron Lee	G
Ron Livingstone	C
Ron Moore	C
Ron Reed	F
Ron Riley	F
Ron Rowan	F
Ron Shavlik	F
Ron Sobie	G
Ron Valentine	F
Ron Watts	F
Ron Williams	G
Ronald Martin	G
Ronald Murray	G
Ronnie Brewer	F
Ronnie Grandison	F
Ronnie Lester	G
Ronnie MacGilvray	G
Ronnie Murphy	F
Ronnie Price	G
Ronny Turiaf	C
Rony Seikaly	C
Rory Sparrow	G
Rory White	F
Rowland Garrett	F
Roy Hibbert	C
Roy Hinson	C
Roy Hurley	F
Roy Marble	G
Roy Tarpley	F
Roylee Hamilton	G
Ruben Boumtje-Boumtje	C
Ruben Wolkowyski	F
Rudy Fernandez	G
Rudy Gay	F
Rudy Gobert	C
Rudy Hackett	F
Rudy LaRusso	F
Rudy Macklin	F
Rudy Tomjanovich	F
Rudy White	G
Rumeal Robinson	G
Russ Schoene	F
Russ Smith	G
Russell Cross	C
Russell Lee	F
Russell Westbrook	G
Ryan Anderson	F
Ryan Hollins	C
Ryan Kelly	F
Ryan Lorthridge	G
Salim Stoudamire	G
Sam Bowie	C
Sam Cassell	G
Sam Jones	G
Sam Lacey	C
Sam Mitchell	F
Sam Pellom	F
Sam Perkins	F,C
Sam Ranzino	G
Sam Sibert	F
Sam Stith	G
Sam Vincent	G
Sam Williams	G
Sam Worthen	G
Sam Young	G,F
Sammy Smith	F
Samuel Dalembert	C
Samuel Williams	F
Sasha Danilovic	G
Sasha Pavlovic	G,F
Saul Mariaschin	G
Scooter McCray	F
Scot Pollard	F,C
Scott Brooks	G
Scott Burrell	G
Scott English	F
Scott Haffner	G
Scott Haskin	F
Scott Hastings	F
Scott Lloyd	C
Scott Machado	G
Scott May	F
Scott Meents	F
Scott Roth	F
Scott Sims	G
Scott Skiles	G
Scott Wedman	F
Scottie Pippen	G,F
Scotty Hopson	G
Sean Colson	G
Sean Elliott	F
Sean Green	G
Sean May	F,C
Sean Rooks	C
Sean Singletary	G
Sean Williams	F,C
Sebastian Telfair	G
Sedale Threatt	G
Sedric Toney	G
Semih Erden	C
Serge Ibaka	F
Sergei Bazarevich	G
Sergey Karasev	G,F
Sergio Rodriguez	G
Shabazz Muhammad	F
Shabazz Napier	G
Shaler Halimon	G
Shammond Williams	G
Shandon Anderson	G,F
Shane Battier	F
Shane Larkin	G
Shannon Brown	G
Shaquille O'Neal	C
Shareef Abdur-Rahim	F
Shaun Livingston	G
Shavlik Randolph	F
Shawn Bradley	C
Shawn Kemp	F
Shawn Marion	F
Shawne Williams	F
Shayne Whittington	F,C
Shelden Williams	F,C
Shellie McMillon	F
Shelton Jones	F
Shelvin Mack	G
Sherell Ford	F
Sherwin Raiken	G
Si Green	G
Sid Catlett	F
Sid Tannenbaum	G
Sidney Green	F
Sidney Hertzberg	G
Sidney Lowe	G
Sidney Moncrief	G
Sidney Wicks	F
Skeeter Henry	G
Skip Harlicka	G
Slater Martin	G
Slava Medvedenko	F
Sleepy Floyd	G
Slick Watts	G
Sly Williams	F
Smush Parker	G
Solomon Alabi	C
Solomon Hill	F
Sonny Parker	F
Sonny Weems	F
Soumaila Samake	C
Speedy Claxton	G
Spencer Dinwiddie	G
Spencer Hawes	F,C
Spencer Haywood	F
Stacey Arceneaux	F
Stacey Augmon	G,F
Stacey King	F,C
Stan Brown	F
Stan Kimbrough	F
Stan Love	F
Stan McKenzie	F
Stan Miasek	F
Stan Noszka	G
Stan Patrick	F
Stan Pietkiewicz	G
Stan Stutz	G
Stan Washington	G
Stanley Brundy	F
Stanley Jackson	G
Stefano Rusconi	F
Steffond Johnson	F
Stephane Lasme	F
Stephen Bardo	G
Stephen Curry	G
Stephen Graham	G,F
Stephen Thompson	F
Stephon Marbury	G
Steve Alford	G
Steve Blake	G
Steve Bracey	G
Steve Bucknall	F
Steve Burtt	G
Steve Colter	G
Steve Courtin	G
Steve Downing	C
Steve Francis	G
Steve Goodrich	C
Steve Green	F
Steve Hamer	C
Steve Hamilton	F
Steve Harris	G
Steve Hawes	C
Steve Hayes	C
Steve Johnson	C
Steve Jones	G
Steve Kerr	G
Steve Kuberski	F
Steve Lingenfelter	F
Steve Malovic	F
Steve Mix	F
Steve Nash	G
Steve Novak	F
Steve Patterson	C
Steve Sheppard	F
Steve Stipanovich	C
Steven Adams	C
Steven Hunter	C
Steven Smith	G,F
Stevin Smith	G
Stewart Granger	G
Stromile Swift	F,C
Stu Lantz	G
Stuart Gray	C
Sun Yue	G
Sundiata Gaines	G
Swen Nater	C
Sylvester Gray	F
Sylvester Norris	C
T.R. Dunn	G
Taj Gibson	F
Talvin Skinner	F
Tang Hamilton	F
Tarence Kinsey	G
Tarik Black	F
Tariq Abdul-Wahad	G,F
Tate Armstrong	G
Tate George	G
Taurean Green	G
Taylor Griffin	F
Tayshaun Prince	F
Ted Luckenbill	F
Ted Manakas	G
Ted, Hound Dog McClain	G
Tellis Frank	F
Terence Stansbury	G
Terrel Harris	G
Terrell Brandon	G
Terrence Jones	F
Terrence Ross	G,F
Terrence Williams	G,F
Terrico White	G
Terry Catledge	F
Terry Crosby	G
Terry Davis	F,C
Terry Dehere	G
Terry Dischinger	F
Terry Dozier	F
Terry Driscoll	F
Terry Duerod	G
Terry Furlow	G
Terry Porter	G
Terry Teagle	G
Terry Thomas	F
Terry Tyler	F
Thabo Sefolosha	G
Thaddeus Young	F
Thales McReynolds	G
Tharon Mayes	G
Theo Ratliff	C
Thomas Barr	G
Thomas Eddleman	F
Thomas Gardner	G
Thomas Hamilton	C
Thomas Jordan	F
Thomas Robinson	F
Thomas Sanders	F
Thomas Wilson	G
Thurl Bailey	F
Tiago Splitter	F
Tim Bassett	F
Tim Duncan	F
Tim James	F
Tim McCormick	C
Tim Ohlbrecht	F,C
Tim Thomas	F
Tim Young	C
Timofey Mozgov	C
Timothy Hardaway Jr.	G
Tito Horford	C
Tito Maddox	G
TJ Warren	F
Tobias Harris	F
Toby Bailey	G
Toby Kimball	F
Toby Knight	F
Tod Murphy	C
Todd Lichti	G
Todd MacCulloch	C
Todd Mitchell	F
Todd Mundt	C
Togo Palazzi	F
Tom Abernethy	F
Tom Barker	C
Tom Black	C
Tom Boerwinkle	C
Tom Boswell	F
Tom Brennan	F
Tom Burleson	C
Tom Callahan	G
Tom Copa	F
Tom Garrick	G
Tom Gola	G
Tom Gugliotta	F
Tom Hawkins	F
Tom Heinsohn	F
Tom Henderson	G
Tom Hoover	C
Tom Hovasse	F
Tom Ingelsby	G
Tom Kelly	G
Tom King	G
Tom Kozelko	F
Tom Kron	G
Tom Kropp	G
Tom LaGarde	C
Tom Marshall	F
Tom McMillen	F
Tom Meschery	F
Tom Owens	C
Tom Payne	C
Tom Piotrowski	C
Tom Riker	F
Tom Scheffler	C
Tom Sewell	G
Tom Sluby	G
Tom Stith	F
Tom Thacker	G
Tom Tolbert	F
Tom Van Arsdale	F
Tom Workman	F
Tommy Byrnes	G
Tommy Green	G
Tommy Kearns	G
Tommy Patterson	F
Toney Douglas	G
Toni Kukoc	F
Tony Allen	G,F
Tony Battie	C
Tony Bennett	G
Tony Brown	F
Tony Campbell	F
Tony Dawson	F
Tony Delk	G
Tony Farmer	F
Tony Fuller	G
Tony Gaffney	F
Tony Harris	G
Tony Jackson	G
Tony Jaros	F
Tony Kappen	G
Tony Lavelli	F
Tony Massenburg	F,C
Tony Mitchell	F
Tony Parker	G
Tony Price	G
Tony Robertson	G
Tony Snell	F
Tony White	G
Tony Windis	G
Tony Wroten	G
Tony Zeno	F
Torgeir Bryn	F
Torraye Braggs	F
Toure Murry	F
Tracy Jackson	G
Tracy McGrady	G,F
Travis Best	G
Travis Diener	G
Travis Grant	F
Travis Hansen	G,F
Travis Knight	C
Travis Leslie	G
Travis Mays	G
Travis Outlaw	F
Travis Wear	F
Tree Rollins	C
Trent Tucker	G
Trenton Hassell	G,F
Trevor Ariza	F
Trevor Booker	F
Trevor Ruffin	G
Trevor Wilson	F
Trey Burke	G
Trey Thompkins	F
Tristan Thompson	F
Troy Bell	G
Troy Daniels	G
Truck Robinson	F
Ty Lawson	G
Tyler Ennis	G
Tyler Hansbrough	F,C
Tyler Zeller	F,C
Tyreke Evans	G,F
Tyrone Britt	G
Tyrone Nesby	G,F
Tyronn Lue	G
Tyrus Thomas	F
Tyson Chandler	C
Tyus Edney	G
Udonis Haslem	F
Uros Slokar	F
Uwe Blab	C
Vassilis Spanoulis	G
Vern Fleming	G
Vern Gardner	C
Vern Hatton	G
Vern Mikkelsen	F
Vernon Macklin	F
Vernon Maxwell	G
Vester Marshall	F
Vic Bartolome	C
Victor Alexander	F
Victor Claver	F
Victor Oladipo	G
Vin Baker	F
Vince Boryla	F
Vince Carter	G,F
Vince Taylor	G
Vincent Yarbrough	F
Vincenzo Esposito	G
Vinnie Johnson	G
Virgil Vaughn	F
Vitaly Potapenko	F,C
Vitor Faverani	C
Vlade Divac	C
Vladimir Radmanovic	F
Vladimir Stepania	C
Voise Winters	F
Von Wafer	G
Voshon Lenard	G
Wali Jones	G
Walker Russell	G
Walker Russell	G
Wallace Bryant	C
Wallace Jones	F
Wallace Sydnor	G
Wally Anderzunas	C
Wally Osterkorn	F
Wally Rank	F
Wally Szczerbiak	G,F
Wally Walker	F
Walt Bellamy	C
Walt Davis	C
Walt Frazier	G
Walt Gilmore	F
Walt Hazzard	G
Walt Kirk	G
Walt Lautenbach	F
Walt Miller	F
Walt Wesley	C
Walter Berry	F
Walter Bond	G
Walter Budko	F
Walter Davis	G
Walter Devlin	G
Walter Dukes	C
Walter Herrmann	F
Walter Jordan	F
Walter McCarty	F
Walter Palmer	C
Walter Sharpe	F
Ward Gibson	C
Ward Williams	F
Wardell Jackson	F
Warren Kidd	F
Warren Perkins	G
Wat Misaka	G
Wayman Britt	G
Wayman Tisdale	F
Wayne Cooper	C
Wayne Ellington	G
Wayne Embry	C
Wayne Englestad	F
Wayne Hightower	F
Wayne Kreklow	G
Wayne Molis	F
Wayne Radford	G
Wayne Robinson	F
Wayne Sappleton	F
Wayne See	G
Wayne Simien	F
Wayne Stevens	F
Wayne Yates	C
Wes Matthews	G
Wes Unseld	C
Wesley Cox	F
Wesley Johnson	F
Wesley Matthews	G
Wesley Person	G,F
Whitey Skoog	G
Wil Jones	F
Wilbert Kautz	G
Wilbur Holland	G
Wiley Peck	G
Wilfred Goodwin	F
Will Barton	G
Will Blalock	G
Will Bynum	G
Will Cherry	G
Will Frazier	F
Will Perdue	C
William Averitt	G
William Avery	G
William Bedford	C
William Bell	G
William Cunningham	C
William Kennedy	G
William Towery	C
Willie Anderson	G,F
Willie Green	G
Willie Jones	F
Willie Jones	G
Willie McCarter	G
Willie Naulls	F
Willie Norwood	F
Willie Reed	F,C
Willie Smith	G
Willie Somerset	G
Willie Warren	G
Willie White	G
Willie Williams	F
Willie Wise	F
Willis Reed	C
Wilmer Hosket	F
Wilson Chandler	F
Wilson Washington	F
Wilt Chamberlain	C
Win Wilfong	G
Winford Boynes	G
Winfred Jacobs	F
Winston Bennett	G
Winston Crite	F
Winston Garland	G
Woody Sauldsberry	F
World Free	G
Worthy Patterson	G
Wyndol Gray	G
Xavier Henry	G,F
Xavier Silas	G
Yakhouba Diawara	G,F
Yao Ming	C
Yaroslav Korolev	F
Yi Jianlian	F
York Larese	G
Yvon Joseph	F
Zabian Dowdell	G
Zach LaVine	G
Zach Randolph	F
Zaid Abdul-Aziz	C
Zan Tabak	C
Zarko Cabarkapa	F,C
Zarko Paspalj	F
Zaza Pachulia	C
Zeke Sinicola	G
Zeljko Rebraca	C
Zelmo Beaty	C
Zigmund Mihalik	G
Zoran Dragic	G,F
Zydrunas Ilgauskas	C
